11111V11111111333333333333333333301000000000000000000000000000000000000000000000000000000
000000000000003333333333333333333111111111111M1V01111111111111111111111111111111111111111
33333a33333330333333333333333333311111111111111101111111111111100000000000000000000000000
333333333333303333333333333333333111111111111111011111111111111033333303333333303333Q3333
33333333333330p33333333333333333311111111111111101111111111111103333330333333330333333333
33333333333330333333333333333333311111111111111100000000000000003333330333333330333333333
33333333333330333333333333333333311111111111111103333333033333303333330333333330333333333
33333333333330333333333333333333311111111111111103333333033333303333330333333330333333333
3333333333333033333333333333333331111111111111110333333303333330E333330G33333330333333333
33333333333330333333333333333333311111111111111103333333033333303333330333333330333333333
3333333333333033333333333333333331111111111111110w333333033333303333330333333330333333333
33333333333330000000000000000000011111111111111103333333033333303333330333333330333333333
33333333333330333333330333333333011110000000000003333333033333303333330333333330333333333
33333333333330333333330333333333011110333333333303333333033333303333330333333330333333333
33333333333330333333330333333333011110333333333303333333033x33303333330333333330000000000
00000000000000333333330333333333011110333333333300000000000000000000000000000000222222222
33333011111110333333330333333333011110333333333303333330333333303333330333333330222222222
33333011111110333333330333333333011110333333333303333330333333303333330333333330222222222
33333011111110333333330333333333011110333333333303333330333333303333330333333330222222222
33333011111110333333330333333333011110333333333v03333330333333303333330333333330222222222
3333b011111110333333330333333333011110333333333303333330333333303333330333333330222222222
33333011111110333333330333333333011110333333333303333330333333303333330333333330222222222
33333011111110333333330333333333011110333333333303333330z3333330F333330H33333330222222222
333330111111103333n333033333o333011110333333333303333330333333303333330333333330222222222
33333011111110000003000000000000000000333333333303333330333333303333330333333330222222222
33333011111111033333330333333333033330333333333303333330333333303333330333333330222222222
0000000000000003333333033333333303333033333u333303333330333333303333330333333330222222222
33303333333333033333330333333333033330000000000003333330333333303333330333333330R22222222
333033333333330333333303333333330333303333333333033y3330333333303333330333333330111122222
33c03333333333033333330333333333033330333333333300000000000000000000000000000000001112222
33303333333333033333330333333333033330333333333301111111111111101111110111111110300111222
33303333333333033333330333333333033330333333333301111111111111101111110111111110330011122
33303333d33333033333330333333333033330333333333301111111111111101111110111111110333001111
22222200000000033333330m333333330q3330333333333301111111111111101111110111111110333300111
222222033333330333333303333333330333303333333333011111111111111011111I0111111110333330011
22222203333333033333330333333333033330333333333t01111111111111100000000000000000333333001
2222220333333303333333033333333303333033333333330111111111111110111111011111111033333330W
22222203333333033333330333333333033330333333333301111111111111101111110111111110333333001
22222203333333033333330333333333033330333333333301111111111111101111110111111110333330011
22222203333333033333330333333333033330333333333301111111111111101111110111111110333300111
22222203333333033333330333333333033330333333333301111111111111101111110111111110333001111
22222203333333033333330333333333033330333333333301111111111111101111110111111110330011111
2222220333f3330333l3330333333333033330333333333301111111111111101111110111111110300111111
22e20000000000000000000000000000000000000000000000000000000000000000000000000000001111111
T0000h333303j30333k3330111133333333s33333333111103A313333C33333033J3333033K33330111111111
33g30333330333033333330111133333333333333333111103331333333333303333333033333330111111111
33330333330333033333330111133333333333333333111103331333333333303333333033333330111111111
33330333330333033333330111133333333333333333111103331333333333303333333033333330111111111
33330333330333033333330111133333333333333333111103331333333333303333333033333330111111111
33330333330333033333330111133333333333333333111103331333333333303333333033333330111111111
33330333330333033333330111133333333333333333111103331333333333303333333033333330111111111
33330333330333033333330111133333333333333333111103331333333333303333333033333330000000000
33330333330333033333330111133333333333333333111103331333333333303333333033333330333S33333
33330333330333033333330111111111111111111111111103331333333333303333333033333330333333333
33330333330333033333330111111111111111111111111103331333333333303333333L33333330333333333
33330333330333033333330111111111111111111111111103331333333333301111333333333330333333333
33330000000000000000000000000000000000000000000000000000000000001111333333333330333333333
3333330333r333333333330111111111111111111111111103333330333333301111333333333330333333333
33333303333333333333330111111111111111111111111103333330333333301111333333333330333333333
33333303333333333333330111111111111111111111111103333330333333301111333333333330333333333
33333303333333333333330111111111111111111111111103333330333333301111333333333330333333333
33333303333333333333330111111111111111111111111103333330333333301111333333333330333333333
33333303333333333333330111111111111111111111111103333330333333301111333333333330333333333
33333303333333333333330111111111111111111111111103333330333333301111333333333330333333333
000000000000000000000001111111111111111111111111033B3330333D33301111333333333330333333333
111111U1111111111111110000000000000000000000000000000000000000000000000000000000333333333
